example=>exemple
case=>cas
model=>modèle
result=>résultat
way=>façon
problem=>problème
equation=>équation
theory=>théorie
term=>terme
section=>section
idea=>idée
point=>point
figure=>montant
thing=>chose
system=>système
table=>table
question=>question
reason=>raison
effect=>effet
method=>méthode
process=>procédé
factor=>facteur
type=>type
fact=>fait
principle=>principe
reaction=>réaction
issue=>problème
approach=>approche
experiment=>expérience
procedure=>procédure
form=>forme
condition=>condition
rate=>taux
right=>droit
kind=>type
solution=>solution
function=>fonction
change=>changement
value=>valeur
study=>étude
argument=>argument
possibility=>possibilité
ability=>abilité
difference=>différence
law=>loi
range=>série
area=>zone
concept=>concept
analysis=>analyse
conclusion=>conclusion
situation=>situation
paper=>article
policy=>politique
view=>vue
response=>réponse
relationship=>relation
strategy=>stratégie
consequence=>conséquence
assumption=>supposition
step=>étape
period=>période
stage=>scène
purpose=>but
discussion=>discussion
failure=>échec
attempt=>essai
property=>propriété
chapter=>chapitre
feature=>caractéristique
expression=>expression
potential=>potentiel
technique=>technique
topic=>sujet
parameter=>paramètre
mechanism=>mécanisme
instance=>instance
evidence=>indice
part=>partie
introduction=>introduction
test=>test
role=>rôle
objective=>objectif
coefficient=>coefficient
decision=>décision
behaviour=>comportement
intention=>intention
prediction=>prévision
hypothesis=>hypothèse
number=>nombre
implication=>implication
advantage=>avantage
definition=>définition
observation=>observation
notion=>notion
characteristic=>caractéristique
phenomenon=>phénomène
target=>objectif
word=>mot
difficulty=>difficulté
subject=>sujet